///////////////////////////////////////////////////////////////
///////////////////////////////////////////////////////////////
##               %%%%%                              %%%%%%%%%##
##   %%%%%                                    %%%%%%%%%%%%%%%##
##%%%%%%%%%%%%        %%%%%%%%%%%%                           ##
##%%%%%%%%%%%%        %%%%                                   ##
##%%%%%%%%%%%%%%%%%%%%%%%%       %%%%         %%%%%%%%%%%%%%%##
##%%%%%%%%%%%%%%%%%%%                           %%%%%%%%%%%%%##
##                                                    %%%%%%%##
##           %%%%%%%%                                        ##
## + %%%%%%%%%%%%%%%%                                 $$$ %%%##
##%%%%%%%%%%%%%%%%%%%        %%%%%%%%%%%            %%%%%%%%%##
##%%%%%%%%%%%%%%%%%%               %%%%                   %%%##
##                                 %%%%%%%%               %%%##
##                %%%%%%%%%%%%%%%%%%%%%%%%%%%%%%%%%%%%%%%%%%%##
##                                                     $$$$  ##
##                                                           ##
##%%           %%%%%%%%          %%%%%%%%%%%%%%%%%%          ##
##%%%%%%      %%%%%%%%%%              %%%%%%%%%%%%%%%        ##
##                              %%%%%%%                      ##
##                                                           ##
##              %%             %%%%%%%%%%%%           %%     ##
##%%%%%%%%%                   %%%%%%%%%%%%%%%     %          ##
##   %%%%%%                   %%%%%%%%%%%%%%%                ##
##         %%%%%%%%%%%%%%%%%%%%%%      %%       %%%          ##
&                                               %%%%%%%%%%%%%##
///////////////////////////////////////////////////////////////
///////////////////////////////////////////////////////////////