///////////////////////////////////////////////////////////////
///////////////////////////////////////////////////////////////
##      #                     $$$$ #                         ##
##      #                          #                         ##
##         &        %%%%%%%%%%%%%                             ##
##   %%%%%%%%%%%%%%%%%%%%%%%%%%%%%%%%%%                      ##
##   %%%%%%%%%%%%%%%%%%%%%%%%%%%%%%%%%%                      ##
##                                                           ##
##                         %%%%         %%%%%%%%%%%%%%%%%%%%%##
##                         %%%%         %%%%%%%%%%%%%%%%%%%%%##
##                         %%%%                              ##
##                         %%%%                    $$$$      ##
##                         %%%%%%%%%%%%%%%%%%%%%%%%%%%%%%%%%%##
##                                                           ##
##     %%%%%%%%%%%%%%%%%%%%%%%%%%%%%%%%%%                    ##
##                                    %%%                    ##
##                                    %%%                    ##
##                                    %%%                 +  ##
##           %%%%%%%%%%%%%%%%%%%%%%%%%%%%%%%%%%%%%%%%%%%%%%%%##
##                                               %%%%%       ##
##                                               %%%%%       ##
##                                                           ##
##%%%%%%%%%%%%%%%%%%%%%%%%%%%%%%%%%%%%%%%%%%%%%%%%%%%%       ##
##                                                  %%       ##
##   _\\\\_                                                  ##
&   |  $$  |                                                 ##
///////////////////////////////////////////////////////////////
///////////////////////////////////////////////////////////////